111122221111
111111111111
111111111111
111111111111
211133331112
211133331112
211133331112
211133331112
111111111111
111111111111
111111111111
111122221111